Daily 4 Night,1,1,2014,2,1,4,8,15
Daily 4 Night,1,2,2014,3,8,5,8,24
Daily 4 Night,1,3,2014,4,6,7,7,24
Daily 4 Night,1,4,2014,1,2,7,6,16
Daily 4 Night,1,6,2014,7,4,6,9,26
Daily 4 Night,1,7,2014,4,4,9,0,17
Daily 4 Night,1,8,2014,9,9,9,9,36
Daily 4 Night,1,9,2014,7,2,6,4,19
Daily 4 Night,1,10,2014,2,4,5,6,17
Daily 4 Night,1,11,2014,4,3,2,2,11
Daily 4 Night,1,13,2014,5,6,1,5,17
Daily 4 Night,1,14,2014,8,1,0,0,9
Daily 4 Night,1,15,2014,7,5,8,4,24
Daily 4 Night,1,16,2014,2,5,3,1,11
Daily 4 Night,1,17,2014,1,3,5,1,10
Daily 4 Night,1,18,2014,7,9,1,2,19
Daily 4 Night,1,20,2014,4,0,2,0,6
Daily 4 Night,1,21,2014,1,5,1,7,14
Daily 4 Night,1,22,2014,2,4,4,8,18
Daily 4 Night,1,23,2014,2,9,7,5,23
Daily 4 Night,1,24,2014,8,5,2,9,24
Daily 4 Night,1,25,2014,2,0,0,1,3
Daily 4 Night,1,27,2014,6,6,3,8,23
Daily 4 Night,1,28,2014,2,6,9,0,17
Daily 4 Night,1,29,2014,4,3,4,7,18
Daily 4 Night,1,30,2014,1,3,7,4,15
Daily 4 Night,1,31,2014,3,9,3,1,16
Daily 4 Night,2,1,2014,4,0,8,3,15
Daily 4 Night,2,3,2014,1,8,5,2,16
Daily 4 Night,2,4,2014,7,0,9,2,18
Daily 4 Night,2,5,2014,3,0,6,5,14
Daily 4 Night,2,6,2014,8,3,1,2,14
Daily 4 Night,2,7,2014,4,7,1,0,12
Daily 4 Night,2,8,2014,1,6,4,1,12
Daily 4 Night,2,10,2014,1,5,6,3,15
Daily 4 Night,2,11,2014,3,4,8,4,19
Daily 4 Night,2,12,2014,6,3,8,5,22
Daily 4 Night,2,13,2014,6,4,5,6,21
Daily 4 Night,2,14,2014,3,1,4,7,15
Daily 4 Night,2,15,2014,3,2,8,1,14
Daily 4 Night,2,17,2014,9,7,6,5,27
Daily 4 Night,2,18,2014,3,8,1,0,12
Daily 4 Night,2,19,2014,6,7,2,8,23
Daily 4 Night,2,20,2014,6,2,5,7,20
Daily 4 Night,2,21,2014,0,7,4,7,18
Daily 4 Night,2,22,2014,9,3,9,6,27
Daily 4 Night,2,24,2014,5,7,4,7,23
Daily 4 Night,2,25,2014,1,1,0,9,11
Daily 4 Night,2,26,2014,3,0,7,3,13
Daily 4 Night,2,27,2014,4,0,8,1,13
Daily 4 Night,2,28,2014,0,2,1,8,11
Daily 4 Night,3,1,2014,6,3,1,3,13
Daily 4 Night,3,3,2014,6,4,5,5,20
Daily 4 Night,3,4,2014,9,3,3,6,21
Daily 4 Night,3,5,2014,5,1,7,9,22
Daily 4 Night,3,6,2014,6,4,4,3,17
Daily 4 Night,3,7,2014,4,5,7,3,19
Daily 4 Night,3,8,2014,0,9,6,0,15
Daily 4 Night,3,10,2014,7,4,1,3,15
Daily 4 Night,3,11,2014,3,4,5,6,18
Daily 4 Night,3,12,2014,9,9,1,7,26
Daily 4 Night,3,13,2014,7,0,9,6,22
Daily 4 Night,3,14,2014,3,6,0,3,12
Daily 4 Night,3,15,2014,6,0,5,4,15
Daily 4 Night,3,17,2014,5,9,1,5,20
Daily 4 Night,3,18,2014,9,1,6,0,16
Daily 4 Night,3,19,2014,7,1,5,8,21
Daily 4 Night,3,20,2014,7,2,9,3,21
Daily 4 Night,3,21,2014,7,9,8,7,31
Daily 4 Night,3,22,2014,2,2,7,8,19
Daily 4 Night,3,24,2014,9,1,2,0,12
Daily 4 Night,3,25,2014,5,5,5,8,23
Daily 4 Night,3,26,2014,4,9,0,0,13
Daily 4 Night,3,27,2014,9,0,6,6,21
Daily 4 Night,3,28,2014,4,7,7,4,22
Daily 4 Night,3,29,2014,6,8,8,5,27
Daily 4 Night,3,31,2014,0,2,8,8,18
Daily 4 Night,4,1,2014,4,0,1,3,8
Daily 4 Night,4,2,2014,7,4,8,7,26
Daily 4 Night,4,3,2014,8,1,7,6,22
Daily 4 Night,4,4,2014,5,5,4,9,23
Daily 4 Night,4,5,2014,8,2,7,7,24
Daily 4 Night,4,7,2014,2,1,7,1,11
Daily 4 Night,4,8,2014,3,8,0,7,18
Daily 4 Night,4,9,2014,3,8,2,5,18
Daily 4 Night,4,10,2014,9,8,4,1,22
Daily 4 Night,4,11,2014,8,3,3,2,16
Daily 4 Night,4,12,2014,7,1,4,4,16
Daily 4 Night,4,14,2014,6,9,2,8,25
Daily 4 Night,4,15,2014,3,2,1,1,7
Daily 4 Night,4,16,2014,5,6,0,3,14
Daily 4 Night,4,17,2014,1,7,5,0,13
Daily 4 Night,4,18,2014,9,8,0,6,23
Daily 4 Night,4,19,2014,4,8,7,5,24
Daily 4 Night,4,21,2014,8,5,5,6,24
Daily 4 Night,4,22,2014,8,3,0,5,16
Daily 4 Night,4,23,2014,7,0,4,3,14
Daily 4 Night,4,24,2014,7,8,6,5,26
Daily 4 Night,4,25,2014,0,4,1,3,8
Daily 4 Night,4,26,2014,8,8,1,6,23
Daily 4 Night,4,28,2014,6,3,5,2,16
Daily 4 Night,4,29,2014,0,4,0,2,6
Daily 4 Night,4,30,2014,2,2,6,1,11
Daily 4 Night,5,1,2014,2,2,7,8,19
Daily 4 Night,5,2,2014,8,2,9,5,24
Daily 4 Night,5,3,2014,0,6,4,8,18
Daily 4 Night,5,5,2014,0,4,0,4,8
Daily 4 Night,5,6,2014,2,7,9,0,18
Daily 4 Night,5,7,2014,8,2,6,5,21
Daily 4 Night,5,8,2014,8,1,3,4,16
Daily 4 Night,5,9,2014,4,6,5,3,18
Daily 4 Night,5,10,2014,7,3,7,0,17
Daily 4 Night,5,12,2014,7,3,3,2,15
Daily 4 Night,5,13,2014,2,2,5,3,12
Daily 4 Night,5,14,2014,2,3,2,8,15
Daily 4 Night,5,15,2014,5,0,3,2,10
Daily 4 Night,5,16,2014,4,8,6,0,18
Daily 4 Night,5,17,2014,2,1,7,3,13
Daily 4 Night,5,19,2014,8,2,4,7,21
Daily 4 Night,5,20,2014,2,3,5,7,17
Daily 4 Night,5,21,2014,1,8,5,5,19
Daily 4 Night,5,22,2014,0,3,3,4,10
Daily 4 Night,5,23,2014,3,3,7,3,16
Daily 4 Night,5,24,2014,8,9,8,9,34
Daily 4 Night,5,26,2014,8,4,1,1,14
Daily 4 Night,5,27,2014,1,0,0,3,4
Daily 4 Night,5,28,2014,8,7,6,9,30
Daily 4 Night,5,29,2014,6,1,6,5,18
Daily 4 Night,5,30,2014,7,9,5,9,30
Daily 4 Night,5,31,2014,2,3,1,6,12
Daily 4 Night,6,2,2014,7,5,5,3,20
Daily 4 Night,6,3,2014,1,5,8,2,16
Daily 4 Night,6,4,2014,4,6,9,3,22
Daily 4 Night,6,5,2014,2,9,8,8,27
Daily 4 Night,6,6,2014,9,1,2,4,16
Daily 4 Night,6,7,2014,2,9,2,7,20
Daily 4 Night,6,9,2014,5,9,5,5,24
Daily 4 Night,6,10,2014,4,6,8,9,27
Daily 4 Night,6,11,2014,0,8,5,7,20
Daily 4 Night,6,12,2014,8,3,1,9,21
Daily 4 Night,6,13,2014,5,8,7,8,28
Daily 4 Night,6,14,2014,3,8,1,5,17
Daily 4 Night,6,16,2014,9,4,6,8,27
Daily 4 Night,6,17,2014,2,2,1,4,9
Daily 4 Night,6,18,2014,5,4,0,8,17
Daily 4 Night,6,19,2014,3,4,6,4,17
Daily 4 Night,6,20,2014,3,6,8,3,20
Daily 4 Night,6,21,2014,6,4,9,5,24
Daily 4 Night,6,23,2014,3,2,6,5,16
Daily 4 Night,6,24,2014,6,3,6,4,19
Daily 4 Night,6,25,2014,8,8,9,2,27
Daily 4 Night,6,26,2014,3,5,0,5,13
Daily 4 Night,6,27,2014,2,2,1,7,12
Daily 4 Night,6,28,2014,4,4,1,9,18
Daily 4 Night,6,30,2014,6,7,3,7,23
Daily 4 Night,7,1,2014,0,2,2,0,4
Daily 4 Night,7,2,2014,1,7,5,4,17
Daily 4 Night,7,3,2014,9,0,6,7,22
Daily 4 Night,7,4,2014,8,0,6,0,14
Daily 4 Night,7,5,2014,8,0,3,5,16
Daily 4 Night,7,7,2014,0,6,7,4,17
Daily 4 Night,7,8,2014,3,2,8,8,21
Daily 4 Night,7,9,2014,9,0,1,2,12
Daily 4 Night,7,10,2014,6,3,1,6,16
Daily 4 Night,7,11,2014,4,9,5,1,19
Daily 4 Night,7,12,2014,6,7,5,2,20
Daily 4 Night,7,14,2014,5,4,8,4,21
Daily 4 Night,7,15,2014,3,9,2,2,16
Daily 4 Night,7,16,2014,5,5,7,5,22
Daily 4 Night,7,17,2014,3,7,7,0,17
Daily 4 Night,7,18,2014,5,7,1,4,17
Daily 4 Night,7,19,2014,2,7,1,1,11
Daily 4 Night,7,21,2014,7,7,8,6,28
Daily 4 Night,7,22,2014,2,0,0,2,4
Daily 4 Night,7,23,2014,3,7,6,2,18
Daily 4 Night,7,24,2014,7,5,8,3,23
Daily 4 Night,7,25,2014,0,7,0,2,9
Daily 4 Night,7,26,2014,1,0,6,1,8
Daily 4 Night,7,28,2014,7,3,1,9,20
Daily 4 Night,7,29,2014,9,4,1,2,16
Daily 4 Night,7,30,2014,0,2,7,8,17
Daily 4 Night,7,31,2014,5,0,6,7,18
Daily 4 Night,8,1,2014,6,6,2,7,21
Daily 4 Night,8,2,2014,4,6,9,4,23
Daily 4 Night,8,4,2014,9,8,6,9,32
Daily 4 Night,8,5,2014,4,6,5,0,15
Daily 4 Night,8,6,2014,7,9,8,2,26
Daily 4 Night,8,7,2014,3,3,6,5,17
Daily 4 Night,8,8,2014,9,1,0,9,19
Daily 4 Night,8,9,2014,8,4,7,1,20
Daily 4 Night,8,11,2014,8,7,2,9,26
Daily 4 Night,8,12,2014,2,4,5,3,14
Daily 4 Night,8,13,2014,5,3,9,3,20
Daily 4 Night,8,14,2014,5,9,9,1,24
Daily 4 Night,8,15,2014,3,0,7,0,10
Daily 4 Night,8,16,2014,8,6,4,6,24
Daily 4 Night,8,18,2014,3,0,8,6,17
Daily 4 Night,8,19,2014,6,6,7,2,21
Daily 4 Night,8,20,2014,7,9,0,1,17
Daily 4 Night,8,21,2014,9,1,9,6,25
Daily 4 Night,8,22,2014,1,6,4,2,13
Daily 4 Night,8,23,2014,4,6,8,7,25
Daily 4 Night,8,25,2014,5,0,1,3,9
Daily 4 Night,8,26,2014,8,9,6,6,29
Daily 4 Night,8,27,2014,1,3,4,4,12
Daily 4 Night,8,28,2014,6,7,7,6,26
Daily 4 Night,8,29,2014,5,7,2,2,16
Daily 4 Night,8,30,2014,1,5,5,2,13
Daily 4 Night,9,1,2014,9,3,2,8,22
Daily 4 Night,9,2,2014,5,5,1,7,18
Daily 4 Night,9,3,2014,9,5,2,9,25
Daily 4 Night,9,4,2014,1,6,7,9,23
Daily 4 Night,9,5,2014,6,9,4,3,22
Daily 4 Night,9,6,2014,5,4,5,5,19
Daily 4 Night,9,8,2014,7,4,5,1,17
Daily 4 Night,9,9,2014,4,2,1,3,10
Daily 4 Night,9,10,2014,0,4,0,5,9
Daily 4 Night,9,11,2014,3,8,3,3,17
Daily 4 Night,9,12,2014,2,7,9,7,25
Daily 4 Night,9,13,2014,2,8,6,8,24
Daily 4 Night,9,15,2014,0,9,1,9,19
Daily 4 Night,9,16,2014,4,2,0,4,10
Daily 4 Night,9,17,2014,6,8,1,1,16
Daily 4 Night,9,18,2014,9,8,2,7,26
Daily 4 Night,9,19,2014,6,0,6,3,15
Daily 4 Night,9,20,2014,4,5,7,5,21
Daily 4 Night,9,22,2014,6,3,3,8,20
Daily 4 Night,9,23,2014,1,1,8,9,19
Daily 4 Night,9,24,2014,8,9,2,9,28
Daily 4 Night,9,25,2014,4,9,8,0,21
Daily 4 Night,9,26,2014,5,9,2,0,16
Daily 4 Night,9,27,2014,8,5,4,5,22
Daily 4 Night,9,29,2014,0,8,3,5,16
Daily 4 Night,9,30,2014,2,4,6,4,16
Daily 4 Night,10,1,2014,9,0,0,1,10
Daily 4 Night,10,2,2014,2,8,3,7,20
Daily 4 Night,10,3,2014,6,9,2,9,26
Daily 4 Night,10,4,2014,6,0,2,8,16
Daily 4 Night,10,6,2014,5,7,6,5,23
Daily 4 Night,10,7,2014,9,4,8,6,27
Daily 4 Night,10,8,2014,3,3,7,8,21
Daily 4 Night,10,9,2014,1,9,5,9,24
Daily 4 Night,10,10,2014,6,5,7,7,25
Daily 4 Night,10,11,2014,6,0,8,7,21
Daily 4 Night,10,13,2014,0,5,7,0,12
Daily 4 Night,10,14,2014,7,3,5,8,23
Daily 4 Night,10,15,2014,2,8,5,7,22
Daily 4 Night,10,16,2014,0,8,9,8,25
Daily 4 Night,10,17,2014,9,1,0,4,14
Daily 4 Night,10,18,2014,4,4,8,6,22
Daily 4 Night,10,20,2014,2,3,0,3,8
Daily 4 Night,10,21,2014,5,3,3,5,16
Daily 4 Night,10,22,2014,8,0,7,4,19
Daily 4 Night,10,23,2014,7,4,4,1,16
Daily 4 Night,10,24,2014,5,0,7,2,14
Daily 4 Night,10,25,2014,3,5,0,9,17
Daily 4 Night,10,27,2014,4,6,8,5,23
Daily 4 Night,10,28,2014,9,9,1,9,28
Daily 4 Night,10,29,2014,4,5,1,7,17
Daily 4 Night,10,30,2014,5,1,9,6,21
Daily 4 Night,10,31,2014,0,9,7,6,22
Daily 4 Night,11,1,2014,9,9,0,0,18
Daily 4 Night,11,3,2014,3,3,5,8,19
Daily 4 Night,11,4,2014,5,4,2,3,14
Daily 4 Night,11,5,2014,8,1,9,7,25
Daily 4 Night,11,6,2014,9,1,7,7,24
Daily 4 Night,11,7,2014,5,0,2,1,8
Daily 4 Night,11,8,2014,5,3,3,9,20
Daily 4 Night,11,10,2014,9,6,8,4,27
Daily 4 Night,11,11,2014,7,2,0,1,10
Daily 4 Night,11,12,2014,8,1,2,6,17
Daily 4 Night,11,13,2014,0,7,4,5,16
Daily 4 Night,11,14,2014,4,4,7,2,17
Daily 4 Night,11,15,2014,7,9,6,3,25
Daily 4 Night,11,17,2014,4,9,1,0,14
Daily 4 Night,11,18,2014,2,0,2,4,8
Daily 4 Night,11,19,2014,6,8,2,9,25
Daily 4 Night,11,20,2014,4,0,2,8,14
Daily 4 Night,11,21,2014,6,4,1,3,14
Daily 4 Night,11,22,2014,1,7,0,2,10
Daily 4 Night,11,24,2014,4,6,2,6,18
Daily 4 Night,11,25,2014,1,4,7,4,16
Daily 4 Night,11,26,2014,6,8,9,0,23
Daily 4 Night,11,27,2014,9,1,4,6,20
Daily 4 Night,11,28,2014,2,8,4,3,17
Daily 4 Night,11,29,2014,0,8,7,5,20
Daily 4 Night,12,1,2014,8,8,8,2,26
Daily 4 Night,12,2,2014,2,1,2,5,10
Daily 4 Night,12,3,2014,7,2,4,2,15
Daily 4 Night,12,4,2014,0,1,1,0,2
Daily 4 Night,12,5,2014,2,6,1,7,16
Daily 4 Night,12,6,2014,0,2,3,3,8
Daily 4 Night,12,8,2014,8,1,5,5,19
Daily 4 Night,12,9,2014,1,2,7,5,15
Daily 4 Night,12,10,2014,0,7,9,8,24
Daily 4 Night,12,11,2014,2,8,1,5,16
Daily 4 Night,12,12,2014,4,6,2,6,18
Daily 4 Night,12,13,2014,1,4,1,6,12
Daily 4 Night,12,15,2014,3,2,4,1,10
Daily 4 Night,12,16,2014,9,3,7,9,28
Daily 4 Night,12,17,2014,5,3,9,7,24
Daily 4 Night,12,18,2014,7,1,5,6,19
Daily 4 Night,12,19,2014,6,8,7,1,22
Daily 4 Night,12,20,2014,2,3,4,2,11
Daily 4 Night,12,22,2014,1,3,4,7,15
Daily 4 Night,12,23,2014,4,1,6,7,18
Daily 4 Night,12,24,2014,3,7,5,7,22
Daily 4 Night,12,25,2014,7,7,9,2,25
Daily 4 Night,12,26,2014,0,7,1,9,17
Daily 4 Night,12,27,2014,0,3,4,9,16
Daily 4 Night,12,29,2014,4,7,4,7,22
Daily 4 Night,12,30,2014,3,4,9,3,19
Daily 4 Night,12,31,2014,7,7,3,7,24